1111111111111111111111
1CCCCCCCCCCCCCCCCCCCP1
1CCCCCCCCCCCCCCCCCCCC1
1CCCCCCCCCCCCCCCCCCCC1
1CCCCCCCCCCCCCCCCCCCC1
1ECCCCCCCCCCCCCCCCCC11
1111111111111111111111