11111111111111111111
1E100000000000000C11
11000000000000000101
1C000000000000000P11
11111111111111111111